gloves(ɡləv) : găng tay
scarf(skärf) : khăn quàng cổ
uniform(ˈyo͞onəˌfôrm): đồng phục
sweater(ˈswedər): áo len
dress:(dres) Váy
Suit(so͞ot) : com lê
sneaker() : giày thể thao
skirt(skərt): chân váy
shirt(SHərt): áo sơ mi
T-Shirt(ˈtē ˌSHərt): áo sơ mi
belt(): thắt lưng
jeans : quần bò
trousers(ˈtrouzərz) : quần tây âu trousers 
tie : cà vạt tie
sock(säk) : tất
glasses: kính
coat(kōt): áo choàng

jacket: áo khoác

tracksuit : bộ quần áo thể thao

shoes: giầy

shorts : quần đùi

well dressed (wel drest): mặc đẹp

casually dressed :mặc giản 

dressed : mặc quần áo



got:đã lấy
have got : đã có

My favorite  is football
i've got an orange T-shirt. it's  my favorite 
My favorite shore are white;

tobe + Having +on .... ~ wearing
Andy us wearing a blue suit with red tie
also (ˈôlsō) : cung the
Standing (ˈstandiNG) :Đứng
cousin (ˈkəz(ə)n): chị em họ
leather(ˈleT͟Hər) :da
carry (ˈkerē) : đeo

 head  : đầu
face : mặt 
ear(ir) : tai 
eye (i) : tai
mouth miệng
tougue (təNG): Lưỡi
tooth (to͞oTH) 1 cái răng
teeth : nhiều cái răng.
 lip : Môi
nose (nōz) : mũi
shoilder : mũi
chest: ngực 
stomach(ˈstəmək): bụng 
arm : cánh tay
hand: tay
finger : ngón tay
knee (nē): đầu gối
leg : chân
foot : 1 bàn chân
feet : nhiều bàn chân
toe (tō) : ngón chân 
hair: tóc
curly hair : tóc xoăn
straight hair : tóc thẳng
log hair : tóc thẳng
short hair : tóc ngắn
the pain :  bị đau


what do/does +S + somebody look like ?









